.................| |...............||........................||.......................||..
\\.......Odra..../_\K..............||.....Ogród Botaniczny...||.......................||..
.\\~~~~~~~~~~~~~//~\\..............||.....**************.... //.......................||..
.||~~~~~~~____~~//~~~\\............\\...******************..//........................||..
.\\~~~~~~/K''K\~~~~~~\\............K\\.******************..//K........................||..
..\\.====| Wyspa|~~~~~~\\............\_================  =_/..........................||..
...\\~~~~\Słod. /~~~~~~~\\.............................||............................K||..
....\\~~~~~----~\\~~~~~~~\\........................B...||.......______________........||..
....K\\~~~~~~~~~~\_=======  =========================== |....../..............\.......||..
......\\~~~~~~~~~~~~~~~~~~~\\.............K............||...../.....Plac.......\B.....||..
.......\\~~~~~~~~~~~~~~~~~~~\\.........................||...B|....Grunwaldzki...|===== |..
...Hala.\\~~~~~~~~~~~~~~~~~~~\\........................| =====\................/......||..
..Targowa\\.~~~~~~~~~~~~~~~~~~\\K......................||......\______________/.......||..
..........\\~~~~~~~~~~~~~~~~~~~\\......................||K...........................B||..
..........K\\.~~~~~~~~~~~~~~~~~~\\.....................||.............................||..
...........||~~Most Grunwaldzki~~\\...........K......._/|__...........................||..
............\\====================  ==================___ /..________________________..\\.
........Galeria.~~~~~~~~~~~~~~~~~//.....................//../........................\..\\
......Dominikańska~~~~~~~~~~~~~~~||....................//../......Politechnika........|.||
............B...\\.~~~~~~~~~~~~~~~\\..................//..|.......Wrocławska..........|.||
..................Park~~~~~~~~~~~~~\\...............K||....\..........................|.||
...............Słowackiego~~~~~~~~~~\\................\\.....\________________________/.||
...............***********~~~~~~~~~~~\\................\\...............................||
...............***********~~~~~~~~~~~~\\................\===============================_/
.........................\\~~~~~~~~~~~~\\............................................K....
..........................\\.~~~~~~~~~~~\\................................................
