~~~~~~~~~~~~~~~~~|.|...............||.............................||..........................................................||.......
\~~~~~~~~~~~~~~~~|.|...............||.............................||..........................................................||.......
\\~~~~~~~~~~~~~~~/.\...............||.....Ogród Botaniczny........||..........................................................||.......
.\\~~~~~~~~~~~~~//~\\..............||.....*******************.... //===========================================================|.......
.||~~~~~~~~~~~~~//~~~\\............\\...***********************..//..........................................||...............||.......
.\\~~~~~~/\\\\\~~~~~~\\.............\\.***********************..//...........................................||...............||.......
..\\=====/ Wyspa\~~~~~~\\............\==========================/............................................||...............||.......
...\\~~~~\Słod  /~~~~~~~\\..................................||...............................................||...............||.......
....\\~~~~======\\~~~~~~~\\.................................||............________________________...........||...............||.......
.....\\~~~~~~~~~~\===========================================|.........../........................\..........||...............||.......
......\\~~~~~~~~~~~~~~~~~~~\\...............................||........../.....Plac.................\.........||...............||.......
.......\\~~~~~~~~~~~~~~~~~~~\\..............................||........./....Grunwaldzki.............\========================= |.......
........\\~~~~~~~~~~~~~~~~~~~\\.............................|===========\........................../..........................||.......
.........\\~~~~~~~~~~~~~~~~~~~\\............................||...........\________________________/...........................||.......
...........\\~~~~~~~~~~~~~~~~~~~\\..........................||................................................................||.......
...........||~~~~~~~~~~~~~~~~~~~~\\.........................||................................................................||.......
............\\================================================================================================================||======.
.............\\~~~~~~~~~~~~~~~~~~//.........................................//............_.................................._..\\.....
..............\\~~~~~~~~~~~~~~~~~||........................................//............_......Politechnika.................._.||.....
................\\~~~~~~~~~~~~~~~~\\......................................//............_.......Wrocławska...................._.||.....
.................\\~~~~~~~~~~~~~~~~\\....................................//.............._...................................._.||.....
..................\\~~~~~~~~~~~~~~~~\\....................................\\...............__________________________...........||.....
...................\\~~~~~~~~~~~~~~~~\\....................................\\...................................................||.....
....................\\~~~~~~~~~~~~~~~~\\....................................\====================================================/.....
.......................\\~~~~~~~~~~~~~~\\..............................................................................................
..........................\\~~~~~~~~~~~~\\.............................................................................................
...........................\\~~~~~~~~~~~~~\\...........................................................................................
............................\\~~~~~~~~~~~~~\\..........................................................................................
.............................\\~~~~~~~~~~~~~\\.........................................................................................
..............................\\~~~~~~~~~~~~~\\........................................................................................
...............................\\~~~~~~~~~~~~~\\.......................................................................................
................................\\~~~~~~~~~~~~~\\......................................................................................
.................................\\~~~~~~~~~~~~~\\.....................................................................................
..................................\\~~~~~~~~~~~~~\\....................................................................................
...................................\\~~~~~~~~~~~~~\\...................................................................................
....................................\\~~~~~~~~~~~~~\\..................................................................................
.....................................\\~~~~~~~~~~~~~\\.................................................................................
......................................\\~~~~~~~~~~~~~\\................................................................................
.......................................\\~~~~~~~~~~~~~\\...............................................................................